F 220,100,34

NO ./path_to_the_north_texture
SO ./path_to_the_south_texture








EA .////////





C 225,30,0



               

WE ./path_to_the_west_texture
111111111111111      
100000N00011111111111111111111
10000000000000000001
11111111111111111111111111   1