NO   ./textures/ddd.xpm
SO   ./textures/brick1.xpm
WE   ./textures/hitlerm7echer.xpm
EA   ./textures/ttt.xpm

F 192,192,192
C 0,191,255

1111111111111111111111111111
1000000000000000000000000001
1000000000000000000000000001
1000000000000000000000000001
1000011100111001110011100001
1000010100001000010010100001
1000000100111001110000100001
1000000100001000010000100001
1000001110111001110000100001
1000000000000000000000000001
1000000000000000000000000001
100000000000000000000W000001
1000000000000000000000000001
1111111111111111111111111111