NO   ./textures/holly_symbole_1_.xpm
WE   ./textures/eagle_1_.xpm
SO   ./textures/adolf_flag_1_.xpm
EA   ./textures/eagle_WB_1_.xpm

F 192,192,192
C 30,144,255

1111111111111111111111111111
1000000000000000000000000001
1000000000000000000000000001
1000000000000000000000000001
1000011100111001110011100001
1000010100001000010010100001
1000000100111001110000100001
1000000100001000010000100001
1000001110111001110000100001
1000000000000000000000000001
1000000000000000000000000001
100000000000000000000N000001
1000000000000000000000000001
1111111111111111111111111111