

            



NO ./textures/ttt.xpm
SO ./textures/AnyConv.com__hitlerm7echer(1).xpm
WE ./textures/ddd.xpm
EA ./textures/nser1.xpm

F 220,100,0
C 225,32,0
                 
        111111111111111111111111
        1000000000110000000000001
        1011000001110000000000001
        1001000000000000000000001
111111111011000001110000000000001
100000000011000001110000000011111
11110111111111011100000010001
11110111111111011101010010001
11000000110101011100000010001
10000000000000001100000010001
10000000000000001101010010001
11000001110101011111011110W0111
11110111 1110101 101111010001
11111111 1111111 111111111111