F 220,100,34

NO ./textures/ttt.xpm
SO ./textures/AnyConv.com__hitlerm7echer(1).xpm
WE ./textures/ddd.xpm
EA ./textures/nser1.xpm

















               


C 225,30,0
1111111111111111111111111111111111111111111111111111
1000000000000001
111111111111111
1000001000000001
100001N10011111111111111111111
10000010000000000001
10000000000000000001
11111111111111111111111111
1111111111111111111111111111111111111111111111111111
11111111111111111111111111